
        11111111111   
1111111111000000111
1000000000001111
10000000000000001111111111111111111
100001000100000000000000000000000011
10000000000011111111111111111111111
1000000000001
1111111111111
